{   
    "arenas": [
        {
            "name": "Forêt Enchantée",
            "layout": [
                [0,0,0,2,0,0,0,0,0,0],
                [0,0,1,2,0,0,3,3,0,0],
                [0,0,1,0,0,0,0,1,2,1],
                [3,0,1,3,0,0,2,1,1,1],
                [0,0,0,3,0,0,0,0,0,0],
                [0,2,0,0,0,0,0,0,3,0],
                [0,2,0,0,2,2,1,0,0,0],
                [0,0,0,0,1,1,1,0,0,0],
                [0,3,1,1,1,1,1,3,0,0],
                [0,3,0,3,3,3,0,3,0,0]
            ]
        },
        {
            "name": "Désert aride",
            "layout": [
                [1,1,1,1,0,0,0,0,0,0],
                [1,1,1,0,0,0,2,2,0,0],  
                [0,3,0,0,0,0,0,0,0,0],
                [0,0,0,0,0,1,0,3,0,0],
                [0,0,2,0,0,1,1,1,0,0],
                [1,0,0,0,0,1,1,1,0,0],
                [1,1,1,0,0,1,2,1,0,0],
                [1,1,1,3,0,0,0,0,3,0],
                [0,0,1,0,0,0,0,1,1,1],
                [0,0,0,0,2,1,1,1,1,1]
            ]

        },
        {
            "name": "Ruines antiques",
            "layout": [
                [0,0,0,0,0,0,0,0,3,3],
                [0,0,0,0,0,0,0,0,0,0],
                [0,2,3,0,2,0,0,2,1,1],
                [0,0,0,0,0,0,0,0,0,1],
                [1,0,0,0,2,3,0,0,0,0],
                [1,2,0,2,2,2,0,2,0,0],
                [1,0,0,0,2,0,0,0,3,0],
                [0,0,0,0,0,0,1,0,3,0],
                [0,2,0,0,2,0,1,2,3,0],
                [3,3,0,0,0,1,1,0,0,0]
            ]
        },
        {
            "name": "Île Mystère",
            "layout":  [
                [0,1,1,1,0,0,0,0,0,0],
                [0,3,3,3,0,0,0,0,0,0],
                [0,0,0,0,0,0,2,2,0,0],
                [0,0,0,0,0,0,0,0,0,1],
                [0,0,0,0,2,2,2,0,0,1],
                [0,0,0,0,0,2,0,0,0,1],
                [0,0,3,0,0,0,0,0,0,1],
                [0,0,3,3,0,0,0,0,0,0],
                [0,1,1,1,1,1,1,0,0,0],
                [0,0,0,0,1,1,1,0,0,0]
            ]
        },
        {
            "name": "Chantier abandonné",
            "layout": [
                [3,3,3,0,2,2,0,3,3,3],
                [3,0,0,0,0,0,0,0,0,3],
                [3,0,0,0,0,0,0,0,0,3],
                [0,0,0,0,0,0,0,0,0,0],
                [0,0,0,0,0,0,0,0,0,2],
                [0,0,0,0,0,0,0,0,0,2],
                [0,0,0,0,0,0,0,0,0,0],
                [3,0,0,0,0,0,0,0,0,3],
                [3,0,0,0,0,0,0,0,0,3],
                [3,3,3,0,2,2,0,3,3,3]
            ]
        },
        {
            "name": "Mission Impossible",
            "layout": [
                [0,0,0,0,0,0,0,0,3,0],
                [0,3,3,0,0,0,0,0,3,0],
                [0,0,0,0,0,0,0,0,0,0],
                [0,0,0,0,2,2,2,0,0,0],
                [0,0,0,0,2,0,2,0,0,0],
                [0,0,0,0,0,0,0,0,0,0],
                [0,0,0,0,0,0,0,3,3,0],
                [0,0,3,0,0,0,0,0,0,0],
                [0,0,3,0,0,0,0,0,0,0],
                [0,0,0,0,0,0,0,0,0,0]
            ]
        }
    ]
}
